1111111111111111111111111111111111
1E000000A000000C00000C00010E000001
1C10C10100100000101001000A00010101
1000010010101010A01001000A0A010101
11P0000000C00C000010000A000C000001
1000010010101010001001000100010101
1111111111111111111111111111111111